111111111111
1P0000000C11
111111101101
100001001C01
101000101101
10C1O0000101
111110111101
10000000O001
111010111101
100C10001E01
1100001O1001
111111111111