1111111111111111111111111111
100000000000000000000001C111
1100000000001E10000000000111
1000000000000100000E00000001
1000E0000000000000000001P111
1111111111111111111111111111