1111111111111111111111111111
100000000000010000000001C111
1100000000001E10000000000111
1000000000000100000000000001
100000000000000000000001P111
1111111111111111111111111111