1111111111111111111111111111
1C0000000000000000000001C111
1100000000001E10000000000111
1000000000000100000C00000001
10000000C000000000000001P111
1111111111111111111111111111