11111111111111111111111111
1C000000000000000000O000E1
10000000000111000000000011
100000000010000000000000O1
1P000000000000000000000011
11111111111111111111111111