11111111111111111111111111111111111111111111111111111111
100000000000000000000001C0000000000000000000000000000001
1100000000001E100000000001110000000000000000000000000001
10000000000001000000000000000000000000000000000000000001
100000000000000000000001P1110000000000000000000000000001
11111111111111111111111111111111111111111111111111111111